. . . . . . . . . . . . . . . 
. # # # # # # # # # # # # # . 
. # . . X # . . . . . . . # . 
. # . . X . . # . . . . . # . 
. # . . X # . . . . . . . # . 
. # - - - . . . . . . . . # . 
. # . . . . . . . . . . . # . 
. # . . . . . . . . . . . # . 
. # . . . . . . . . . . . # . 
. # . . . . . . . . . . . # . 
. # . . . . . . . . . . . # . 
. # . . . . . . . . . . . # . 
. # . . . . . . . . . . . # . 
. # # # # # # # # # # # # # . 
. . . . . . . . . . . . . . . 
