. # # # # # . . . . . . . . .
. # . . . # # # # . . . . . .
. # . . . # . . # . . . . . .
. # # . . . . - # . . . . . .
# # # . # # # - # . . . . . .
# . X . # . # - # . . . . . .
# . X X # . # # # . . . . . .
# Y . . # . . . . . . . . . .
# # # # # . . . . . . . . . .
. . . . . . . . . . . . . . .
. . . . . . . . . . . . . . .
. . . . . . . . . . . . . . .
. . . . . . . . . . . . . . .
. . . . . . . . . . . . . . .
. . . . . . . . . . . . . . .