# # # # # . . . . . . . . . .
# . . . # # # # # . . . . . .
# . X . # . . . # . . . . . .
# . . . # X # . # . . . . . .
# # # X . . . . # . . . . . .
. # . . . # # # # . . . . . .
. # . Y - - - # . . . . . . .
. # # # # # # # . . . . . . .
. . . . . . . . . . . . . . .
. . . . . . . . . . . . . . .
. . . . . . . . . . . . . . .
. . . . . . . . . . . . . . .
. . . . . . . . . . . . . . .
. . . . . . . . . . . . . . .
. . . . . . . . . . . . . . .