# # # # # # # # # # # # # # #
# . . . . . # . . . . . # - #
# . . . . . # . . . . . # - #
# Y . . X . . X . X . . # - #
# . . . . . # . . . . . . . #
# . . . . . # . . . . . . . #
# # # # # # # # # # # # # # #
. . . . . . . . . . . . . . .
. . . . . . . . . . . . . . .
. . . . . . . . . . . . . . .
. . . . . . . . . . . . . . .
. . . . . . . . . . . . . . .
. . . . . . . . . . . . . . .
. . . . . . . . . . . . . . .
. . . . . . . . . . . . . . .