. . . . . . . . . . . . . . .
. . . # # # . # # # # . . . .
. . # # . # . # . . # . . . .
. # # . . # # # . . # . . . .
# # . X . . . . . . # . . . .
# . . . Y X . # . . # . . . .
# # # . X # # # . . # . . . .
. . # . . # - - . . # . . . .
. # # . # # - # . # # . . . .
. # . . . . . . # # . . . . .
. # . . . . . # # . . . . . .
. # # # # # # # . . . . . . .
. . . . . . . . . . . . . . .
. . . . . . . . . . . . . . .
. . . . . . . . . . . . . . .