. . . . . . . . . . . . . . .
. . . . . . . . . . . . . . .
. . . . . # # # # . . . . . .
. . . . . # . . # # # . . . .
. . . . . # . . . . # . . . .
. . . # # # X - # . # # . . .
. . . # . . X - # . . # . . .
. . . # . # X - . # . # . . .
. . . # Y . . # . . . # . . .
. . . # # # # # # # # # . . .
. . . . . . . . . . . . . . .
. . . . . . . . . . . . . . .
. . . . . . . . . . . . . . .
. . . . . . . . . . . . . . .
. . . . . . . . . . . . . . .
