. . . . . . . . . . . . . . . 
. . . . . . . . . . . . . . . 
. . . # # # # # # # # # . . . 
. . . # . . - - - - - # . . . 
# # # # . . . . . . . # . . . 
# . . # # # # . # # # # # # # 
# . X . . . . . . . . . X . # 
# . . . # # X . X . # . . . # 
# . . . # # . Y # # # # X . # 
# # # # # # # # # . . # . . # 
. . . . . . . . . . . # # # # 
. . . . . . . . . . . . . . . 
. . . . . . . . . . . . . . . 
. . . . . . . . . . . . . . . 
. . . . . . . . . . . . . . . 
