. . . . . . . . . . . . . . . 
. . . . . . . . . . . . . . . 
. . . . . . . . . . . . . . . 
. . . . . . . . . . . . . . . 
. . . . . . . . . . . . . . . 
. . . . . . # # # . . . . . . 
. . . . . . . . . # . . . . . 
. . . . . . . # # # . . . . . 
. . . . . . . . . . . . . . . 
. . . . . X X . . . . . . . . 
. . . . . - - . . . . . . . . 
. . . . . . . . . . . . . . . 
. Y . . . . . . . . . . . . . 
. . . . . . . . . . . . . . . 
. . . . . . . . . . . . . . . 
