. . . . . . . . . . . . . . . 
. . . # # # # # # # # # # . . 
. . . # . . . . . . . . # . . 
. . . # . . . X . . . . # . . 
. . . # . . . . . . . - # . . 
. . . # # # # X # # # - # . . 
. . . # . . . . . . . - # . . 
. . . # . . . X . . . . # . . 
. . . # . . . . . . . Y # . . 
. . . # # # # # # # # # # . . 
. . . . . . . . . . . . . . . 
. . . . . . . . . . . . . . . 
. . . . . . . . . . . . . . . 
. . . . . . . . . . . . . . . 
. . . . . . . . . . . . . . . 
