. . . . . . . . . . . . . . . 
. . . . # # # # # # . . . . . 
. . . . # . . . . # # # # # . 
. . . . # . . . . . . . . # . 
. . . . # - - - # . . . . # . 
. . # # # # # # # . . . . # . 
. . . # . . . . X . . X . # . 
. . . # . X . # . . . . # # . 
. . . # . . . # . . Y # # . . 
. . . # # # # # # # # # . . . 
. . . . . . . . . . . . . . . 
. . . . . . . . . . . . . . . 
. . . . . . . . . . . . . . . 
. . . . . . . . . . . . . . . 
. . . . . . . . . . . . . . . 
